###########
#         #
# ####### #
#         #
###########