#################
#   #   #   #   #
# # # # # # # # #
# #   #   #   # #
# ############# #
#             # #
#################
#################
#################